11111111111111111111
10000000000000000000
10000000000000000001
10000000000000000001
10000000000000000001
10000020222222000001
10000000000000000001
10000000000000000001
10000000000000000001
11111111100011111111
12345078900000000001
10000000000000000001
10000000000000000001
10000000000000000001
10000000000000000001
10000000000000000001
10000000000000000001
10000000222000000001
10000000262000000001
11111111111111111111